Original file: Chapitre_9.txt

Replaced words:
auraient -> aurait (replaced 1 times)
étaient -> était (replaced 1 times)
visibles -> visible (replaced 1 times)
marches -> marche (replaced 1 times)
blanc -> blan (replaced 1 times)
année -> anné (replaced 2 times)
arrivée -> arrivé (replaced 1 times)
dirigée -> dirigé (replaced 1 times)
dégagée -> dégagé (replaced 1 times)
gorgée -> gorgé (replaced 1 times)
idée -> idé (replaced 2 times)
journée -> journé (replaced 1 times)
levée -> levé (replaced 1 times)
montée -> monté (replaced 1 times)
collée -> collé (replaced 1 times)
rencontrées -> rencontrés (replaced 1 times)
approchées -> approchés (replaced 1 times)
utilisées -> utilisés (replaced 1 times)
furtifs -> furtif (replaced 1 times)
radioactifs -> radioactif (replaced 2 times)
pâles -> pâle (replaced 1 times)
différents -> différent (replaced 1 times)
parents -> parent (replaced 1 times)
prudents -> prudent (replaced 1 times)
soient -> soie (replaced 1 times)
ment -> ment (replaced 1 times)
est-ce -> es ce (replaced 2 times)
est -> es (replaced 26 times)
fois -> foi (replaced 10 times)
elles -> elle (replaced 1 times)
ils -> il (replaced 3 times)
cette -> cet (replaced 8 times)
les yeux -> lé zieu (replaced 1 times)
Cheveux -> Cheveu (replaced 2 times)
prends -> prend (replaced 1 times)
n’es ce -> n’es-ce (replaced 1 times)
