Original file: Chapitre_7.txt

Replaced words:
auraient -> aurait (replaced 1 times)
seraient -> serait (replaced 2 times)
proches -> proche (replaced 1 times)
année -> anné (replaced 1 times)
arrivée -> arrivé (replaced 1 times)
brisée -> brisé (replaced 1 times)
bétonnée -> bétonné (replaced 1 times)
choquée -> choqué (replaced 1 times)
déformée -> déformé (replaced 1 times)
dégoûtée -> dégoûté (replaced 1 times)
effrénée -> effréné (replaced 1 times)
envoyée -> envoyé (replaced 2 times)
gorgée -> gorgé (replaced 1 times)
idée -> idé (replaced 2 times)
journée -> journé (replaced 1 times)
marquée -> marqué (replaced 1 times)
collée -> collé (replaced 1 times)
déroutée -> dérouté (replaced 1 times)
alignées -> alignés (replaced 1 times)
envoyées -> envoyés (replaced 1 times)
captées -> captés (replaced 2 times)
stationnées -> stationnés (replaced 1 times)
événements -> événement (replaced 1 times)
étranges -> étrange (replaced 1 times)
modèles -> modèle (replaced 1 times)
parents -> parent (replaced 3 times)
scintillements -> scintillement (replaced 1 times)
téléphones -> téléphone (replaced 1 times)
soient -> soie (replaced 3 times)
est-ce -> es ce (replaced 4 times)
est -> es (replaced 26 times)
fois -> foi (replaced 3 times)
jours -> jour (replaced 1 times)
sourcil -> sourci (replaced 2 times)
elles -> elle (replaced 3 times)
ils -> il (replaced 21 times)
cette -> cet (replaced 9 times)
ses yeux -> cé zieu (replaced 1 times)
les yeux -> lé zieu (replaced 2 times)
yeux -> zieu (replaced 1 times)
eux-mêmes -> eux-même (replaced 1 times)
saisit -> saisi (replaced 2 times)
