Original file: Chapitre_11.txt

Replaced words:
blancs -> blan (replaced 1 times)
affolée -> affolé (replaced 1 times)
alertée -> alerté (replaced 1 times)
argentée -> argenté (replaced 1 times)
censée -> censé (replaced 1 times)
entrée -> entré (replaced 1 times)
idée -> idé (replaced 1 times)
asphaltée -> asphalté (replaced 1 times)
captivée -> captivé (replaced 1 times)
contaminée -> contaminé (replaced 1 times)
ensanglantées -> ensanglantés (replaced 1 times)
tigrées -> tigrés (replaced 1 times)
vêtements -> vêtement (replaced 2 times)
éléments -> élément (replaced 1 times)
équipements -> équipement (replaced 1 times)
passagers -> passager (replaced 1 times)
rouges -> rouge (replaced 2 times)
étranges -> étrange (replaced 2 times)
vagues -> vague (replaced 1 times)
décents -> décent (replaced 1 times)
immenses -> immense (replaced 1 times)
est-ce -> es ce (replaced 1 times)
est -> es (replaced 20 times)
fois -> foi (replaced 4 times)
jours -> jour (replaced 4 times)
gris -> g'ri (replaced 1 times)
choses -> chose (replaced 1 times)
ils -> il (replaced 7 times)
les yeux -> lé zieu (replaced 1 times)
yeux -> zieu (replaced 1 times)
