Original file: Chapitre_3.txt

Replaced words:
désagréables -> désagréable (replaced 1 times)
auraient -> aurait (replaced 1 times)
avaient -> avait (replaced 1 times)
blanc -> blan (replaced 1 times)
année -> anné (replaced 1 times)
brisée -> brisé (replaced 1 times)
déployée -> déployé (replaced 1 times)
entrée -> entré (replaced 2 times)
idée -> idé (replaced 2 times)
intéressée -> intéressé (replaced 1 times)
collée -> collé (replaced 1 times)
créée -> créé (replaced 1 times)
arrivées -> arrivés (replaced 1 times)
enlevées -> enlevés (replaced 1 times)
repérées -> repérés (replaced 1 times)
vêtements -> vêtement (replaced 1 times)
éléments -> élément (replaced 1 times)
différents -> différent (replaced 1 times)
gloussements -> gloussement (replaced 1 times)
esclaffent -> esclaffe (replaced 1 times)
pédalent -> pédale (replaced 1 times)
est -> es (replaced 15 times)
fois -> foi (replaced 3 times)
sourcils -> sourci (replaced 1 times)
elles -> elle (replaced 3 times)
ils -> il (replaced 14 times)
cette -> cet (replaced 3 times)
ses yeux -> cé zieu (replaced 1 times)
silencieux -> silencieu (replaced 2 times)
